SO ./textures/S.png                 

NO ./textures/N.png  

WE ./textures/W.png   

EA ./textures/E.png

C 128,128,128
F 74, 55, 40 

1111111111111111111111111111111111111111111111111111111111111111111111111111111111
1111111111111111111111111   111
1000000000110010000000001  1 1111
1011000001110001000000001   1111
100100000000000000000000111111111
1111000010000000N1110000000000001    
10000000000000001110111111111111
11100101000000000100000010001    
11100001000000011100010010001
11000000000000011100000010001
10000000000000011000000100001
10000000000000001101010011111
110000001100010111010010111111
111101110000010101101111010101
111111110000011111 111111111111
111111111111111111111